. . T . . . b b b b b b b b . . . T b b
. . . . . . . b b O O O b . . . . . . b
. . . . . . . . b O O b . . . T . . . .
T . . . . . . . . b b . . . . T T . . .
T T . . . R R . . b . . . . . . . . . T
. T . . . R . . . . . . R R . . . . T T
. . . . . . . . . . . . R . . . M M . .
. . . T . . . . . b b . . . . . M . . .
. . . T T . . . b b O b . . . . . . . .
. . . . . . . b b O O O b . . T . . . .
b . . . . . b b O O O O O b . . . . . .
b b . . T . b O O O O O O O b . . T . .
